"a" = (/obj/modified{name = "not_hehe"},/turf,/area)
"b" = (/turf,/area)

(1,1,1) = {"
baba
"}