"a" = (/obj/modified{name = "not_hehe"; bad_var = "bad var"},/turf,/area)
"b" = (/turf,/area)

(1,1,1) = {"
baba
"}