//MAP CONVERTED BY dmm2tgm.py THIS HEADER COMMENT PREVENTS RECONVERSION, DO NOT REMOVE
"a" = (
/turf/turf_type_a,
/area)
"b" = (
/turf,
/area)
"c" = (
/turf/turf_type_b,
/area)

(1,1,1) = {"
a
b
b
a
b
b
b
b
b
a
"}
(2,1,1) = {"
a
b
b
b
b
b
b
b
b
c
"}
(3,1,1) = {"
a
b
a
b
b
b
b
b
b
b
"}
(4,1,1) = {"
a
a
a
b
b
b
b
b
b
b
"}
(5,1,1) = {"
a
a
a
b
b
b
b
b
b
b
"}
(6,1,1) = {"
a
a
a
b
b
b
b
b
b
b
"}
(7,1,1) = {"
a
a
a
b
b
b
b
b
b
b
"}
(8,1,1) = {"
a
a
a
b
b
b
b
b
b
b
"}
(9,1,1) = {"
a
a
a
b
b
b
b
b
b
b
"}
(10,1,1) = {"
a
a
a
b
b
b
b
b
b
c
"}
